@@@@@@@@@@@@@@@@@@@@::::::@@@@@@@@@@@@@@@@@@@@@@
@@@@@@@@@@@@@@@@@@@@@:::::@@@@@@::---::::@@@@::@
@@@@@::::::::*@@@@@@@@@::@@@@@@::--@@@@::@@@@::@
@@@@@:::::::::@@@@@@@@@@@@@@@@::---@@@@::::@@@@@
@@@@@@@:+++::::::@@@@@@@@@@::::---:@@@@@:::@@@@@
@@@@@@@@@@:::::::::@@@@@@@:::::---:@@@@@@@:@@@@@
@@@@@@@@@@@@@@@@:::::::::::@@@@@@@@@@@@@@@:@@::@
@@::::::@@@@@@@@::::::::@@@@@@@@@@@@@@@@@@:@@@@@
@@:::::::@@@@@@@::@#@@@@@@@@@@@@@@@@@@@@@::@@@@@
@@@@@@@@@@@@@@@@::@@@@@@@@@@:::::@@@@@::::::@@@@
@@@@@@@@@@@@@@@@::@@@@@@@@::::oo::::::::@@@@@@@@
@@@@@@@@::::::::::::@@@@@@@@:::::@@@@@@@@@@@@@@@
@@@@@@@@@@@::::ooo::::::::::oo:@@@@@@@@@@@@@@@@@
@@@@@@@@@@@@@@@@@::::ooo:::::::@@@@@@@@@@@@@@@@@
@@@@@@@@@@@@@@::::::ooo:::@@@@@@@@@@@@@:::ooo:@@
@@@@@@@@@@@@@@@@@@:::::::::@@@@@@@@@@@@@::oo:::@