--------------+---------------------------------
..............+................+................
..............+................+................
---------------................-----------------
................................................
.....----------------------------------.........
.....+..........+.TOWN CENTER.+.......+.........
.....+..........+-------------+.......+.........
.....+................................+.........
.....+................................+.........
.....------------.............--------+.........
................................................
-------------------...........------------------
..................+...........+.................
..................+...........+.................
..................+...........+.................