@@::::::@@@@@@@@@@@@@@@@@@@@@@@@@@@@@::::::::@@@
@@@@@@@@@@@@@@:::::::::::@@@@@@@@@@@@:::::::@@@@
@@@@@@@@@@::::::::::::::@@@@@@@@@@@@@@@::::@@@@@
@@@@@@@:::::::::@@@@@@@@@@@@@@@@@@@@@@@@@@@@@@@@
@@@@@@@@@@@@@::::@@@@@@@@@@@@@@@@@@@@@@@@@@@@@@@
@@@@@@@@@@@@@::::::@@@@@@@:::::::::::::@@@@@@@@@
@@@@@@@@@@@@@@@@:::::::::::::::@@@@@@@@@@@@@@@@@
@@@@:::::::::::::::::::::::::::@@@@@@@@@@@@@@@@@
@@@@@@:::::::::::++oo+:::::::::::::@@@@@@@@@@@@@
@@@@@@@@@:::::::+++oo+::::::::@@@@@@@@@@@@@@@@@@
@@@@::::::::::::+++++:::::::::::::@@@@@@@@@@@@@@
@@@@@@:::::::::::::::::::::::@@@@@@@@@@@@@@@@@@@
@@@@@@@@@@@@@@@@@@@@@@@@@@@@@@@@@@@@@@@@:::::@@@
@@@@@@@@@@@@@@@@@@@@@@@@@@@@@@@@@@@@::::::@@@@@@
@:::::::::::@@@@@@@@@@@@@@@@@@@@@@@:::::::::@@@@
@@@@:::::::@@@@@@@@@@@@@@@@@@@@@@@@@::::::::@@@@
